20 20
test.png

28 28 28 28 28 28 28 28 29 1 31 9 9 9 9 9 9 9 9 9 
28 27 27 27 27 27 27 27 29 1 31 9 9 9 9 9 9 9 9 9 
28 27 27 27 27 27 27 27 29 1 31 9 9 9 9 9 9 9 9 9 
28 27 27 27 27 27 27 27 29 1 31 9 9 9 9 9 9 9 9 9 
28 27 27 27 27 27 27 27 29 1 31 9 9 9 9 9 9 9 9 9 
28 27 27 27 27 27 27 27 29 1 31 9 9 9 9 9 9 9 9 9 
28 27 27 27 27 27 27 27 29 1 31 9 9 9 9 9 9 9 9 9 
28 27 27 27 27 27 27 27 29 1 31 9 9 9 9 9 9 9 9 9 
28 27 27 27 27 27 27 27 29 1 31 9 9 9 9 9 9 9 9 9 
28 27 27 27 27 27 27 27 29 1 31 9 9 9 9 9 9 9 9 9 
28 27 27 27 27 27 27 27 29 1 44 22 22 22 23 9 9 9 9 9 
28 27 27 27 27 27 27 27 29 1 1 1 1 1 31 9 9 9 9 9 
28 27 27 27 27 27 27 27 37 38 38 38 51 1 31 9 9 9 9 9 
28 27 27 27 27 27 27 27 27 27 27 27 29 1 31 9 9 9 9 9 
28 27 27 27 27 27 27 27 27 27 27 27 29 1 31 9 9 9 9 9 
28 27 27 27 27 27 27 27 27 27 27 27 29 1 44 22 22 22 22 23 
28 27 27 27 27 27 27 27 27 27 27 27 37 38 38 38 38 51 1 31 
28 27 27 27 27 27 27 28 28 28 28 28 25 25 19 20 28 29 1 31 
28 27 27 27 27 27 27 27 27 27 27 27 27 27 27 27 28 29 1 31 
28 28 28 28 28 28 28 28 28 28 28 28 28 28 28 28 28 29 1 31 
(0,0,0,0,1,)(0,0,0,0,1,)(0,0,0,0,1,)(0,0,0,0,1,)(0,0,0,0,1,)(0,0,0,0,1,)(0,0,0,0,1,)(0,0,0,0,1,)(1,0,0,1,0,)(1,1,0,1,0,)(0,1,0,1,0,)(0,0,0,0,1,)(0,0,0,0,1,)(0,0,0,0,1,)(0,0,0,0,1,)(0,0,0,0,1,)(0,0,0,0,1,)(0,0,0,0,1,)(0,0,0,0,1,)(0,0,0,0,1,)
(0,0,0,0,1,)(0,0,0,0,1,)(0,0,0,0,1,)(0,0,0,0,1,)(0,0,0,0,1,)(0,0,0,0,1,)(0,0,0,0,1,)(0,0,0,0,1,)(1,0,1,1,0,)(1,1,1,1,0,)(0,1,1,1,0,)(0,0,0,0,1,)(0,0,0,0,1,)(0,0,0,0,1,)(0,0,0,0,1,)(0,0,0,0,1,)(0,0,0,0,1,)(0,0,0,0,1,)(0,0,0,0,1,)(0,0,0,0,1,)
(0,0,0,0,1,)(0,0,0,0,1,)(0,0,0,0,1,)(0,0,0,0,1,)(0,0,0,0,1,)(0,0,0,0,1,)(0,0,0,0,1,)(0,0,0,0,1,)(1,0,1,1,0,)(1,1,1,1,0,)(0,1,1,1,0,)(0,0,0,0,1,)(0,0,0,0,1,)(0,0,0,0,1,)(0,0,0,0,1,)(0,0,0,0,1,)(0,0,0,0,1,)(0,0,0,0,1,)(0,0,0,0,1,)(0,0,0,0,1,)
(0,0,0,0,1,)(0,0,0,0,1,)(0,0,0,0,1,)(0,0,0,0,1,)(0,0,0,0,1,)(0,0,0,0,1,)(0,0,0,0,1,)(0,0,0,0,1,)(1,0,1,1,0,)(1,1,1,1,0,)(0,1,1,1,0,)(0,0,0,0,1,)(0,0,0,0,1,)(0,0,0,0,1,)(0,0,0,0,1,)(0,0,0,0,1,)(0,0,0,0,1,)(0,0,0,0,1,)(0,0,0,0,1,)(0,0,0,0,1,)
(0,0,0,0,1,)(0,0,0,0,1,)(0,0,0,0,1,)(0,0,0,0,1,)(0,0,0,0,1,)(0,0,0,0,1,)(0,0,0,0,1,)(0,0,0,0,1,)(1,0,1,1,0,)(1,1,1,1,0,)(0,1,1,1,0,)(0,0,0,0,1,)(0,0,0,0,1,)(0,0,0,0,1,)(0,0,0,0,1,)(0,0,0,0,1,)(0,0,0,0,1,)(0,0,0,0,1,)(0,0,0,0,1,)(0,0,0,0,1,)
(0,0,0,0,1,)(0,0,0,0,1,)(0,0,0,0,1,)(0,0,0,0,1,)(0,0,0,0,1,)(0,0,0,0,1,)(0,0,0,0,1,)(0,0,0,0,1,)(1,0,1,1,0,)(1,1,1,1,0,)(0,1,1,1,0,)(0,0,0,0,1,)(0,0,0,0,1,)(0,0,0,0,1,)(0,0,0,0,1,)(0,0,0,0,1,)(0,0,0,0,1,)(0,0,0,0,1,)(0,0,0,0,1,)(0,0,0,0,1,)
(0,0,0,0,1,)(0,0,0,0,1,)(0,0,0,0,1,)(0,0,0,0,1,)(0,0,0,0,1,)(0,0,0,0,1,)(0,0,0,0,1,)(0,0,0,0,1,)(1,0,1,1,0,)(1,1,1,1,0,)(0,1,1,1,0,)(0,0,0,0,1,)(0,0,0,0,1,)(0,0,0,0,1,)(0,0,0,0,1,)(0,0,0,0,1,)(0,0,0,0,1,)(0,0,0,0,1,)(0,0,0,0,1,)(0,0,0,0,1,)
(0,0,0,0,1,)(0,0,0,0,1,)(0,0,0,0,1,)(0,0,0,0,1,)(0,0,0,0,1,)(0,0,0,0,1,)(0,0,0,0,1,)(0,0,0,0,1,)(1,0,1,1,0,)(1,1,1,1,0,)(0,1,1,1,0,)(0,0,0,0,1,)(0,0,0,0,1,)(0,0,0,0,1,)(0,0,0,0,1,)(0,0,0,0,1,)(0,0,0,0,1,)(0,0,0,0,1,)(0,0,0,0,1,)(0,0,0,0,1,)
(0,0,0,0,1,)(0,0,0,0,1,)(0,0,0,0,1,)(0,0,0,0,1,)(0,0,0,0,1,)(0,0,0,0,1,)(0,0,0,0,1,)(0,0,0,0,1,)(1,0,1,1,0,)(1,1,1,1,0,)(0,1,1,1,0,)(0,0,0,0,1,)(0,0,0,0,1,)(0,0,0,0,1,)(0,0,0,0,1,)(0,0,0,0,1,)(0,0,0,0,1,)(0,0,0,0,1,)(0,0,0,0,1,)(0,0,0,0,1,)
(0,0,0,0,1,)(0,0,0,0,1,)(0,0,0,0,1,)(0,0,0,0,1,)(0,0,0,0,1,)(0,0,0,0,1,)(0,0,0,0,1,)(0,0,0,0,1,)(1,0,1,1,0,)(1,1,1,1,0,)(0,1,1,1,0,)(0,0,0,0,1,)(0,0,0,0,1,)(0,0,0,0,1,)(0,0,0,0,1,)(0,0,0,0,1,)(0,0,0,0,1,)(0,0,0,0,1,)(0,0,0,0,1,)(0,0,0,0,1,)
(0,0,0,0,1,)(0,0,0,0,1,)(0,0,0,0,1,)(0,0,0,0,1,)(0,0,0,0,1,)(0,0,0,0,1,)(0,0,0,0,1,)(0,0,0,0,1,)(1,0,1,1,0,)(1,1,1,1,0,)(1,1,1,1,0,)(1,1,0,1,0,)(1,1,0,1,0,)(1,1,0,1,0,)(0,1,0,1,0,)(0,0,0,0,1,)(0,0,0,0,1,)(0,0,0,0,1,)(0,0,0,0,1,)(0,0,0,0,1,)
(0,0,0,0,1,)(0,0,0,0,1,)(0,0,0,0,1,)(0,0,0,0,1,)(0,0,0,0,1,)(0,0,0,0,1,)(0,0,0,0,1,)(0,0,0,0,1,)(1,0,1,1,0,)(1,1,1,1,0,)(1,1,1,1,0,)(1,1,1,1,0,)(1,1,1,1,0,)(1,1,1,1,0,)(0,1,1,1,0,)(0,0,0,0,1,)(0,0,0,0,1,)(0,0,0,0,1,)(0,0,0,0,1,)(0,0,0,0,1,)
(0,0,0,0,1,)(0,0,0,0,1,)(0,0,0,0,1,)(0,0,0,0,1,)(0,0,0,0,1,)(0,0,0,0,1,)(0,0,0,0,1,)(0,0,0,0,1,)(1,0,1,0,0,)(1,1,1,0,0,)(1,1,1,0,0,)(1,1,1,0,0,)(1,1,1,1,0,)(1,1,1,1,0,)(0,1,1,1,0,)(0,0,0,0,1,)(0,0,0,0,1,)(0,0,0,0,1,)(0,0,0,0,1,)(0,0,0,0,1,)
(0,0,0,0,1,)(0,0,0,0,1,)(0,0,0,0,1,)(0,0,0,0,1,)(0,0,0,0,1,)(0,0,0,0,1,)(0,0,0,0,1,)(0,0,0,0,1,)(0,0,0,0,1,)(0,0,0,0,1,)(0,0,0,0,1,)(0,0,0,0,1,)(1,0,1,1,0,)(1,1,1,1,0,)(0,1,1,1,0,)(0,0,0,0,1,)(0,0,0,0,1,)(0,0,0,0,1,)(0,0,0,0,1,)(0,0,0,0,1,)
(0,0,0,0,1,)(0,0,0,0,1,)(0,0,0,0,1,)(0,0,0,0,1,)(0,0,0,0,1,)(0,0,0,0,1,)(0,0,0,0,1,)(0,0,0,0,1,)(0,0,0,0,1,)(0,0,0,0,1,)(0,0,0,0,1,)(0,0,0,0,1,)(1,0,1,1,0,)(1,1,1,1,0,)(0,1,1,1,0,)(0,0,0,0,1,)(0,0,0,0,1,)(0,0,0,0,1,)(0,0,0,0,1,)(0,0,0,0,1,)
(0,0,0,0,1,)(0,0,0,0,1,)(0,0,0,0,1,)(0,0,0,0,1,)(0,0,0,0,1,)(0,0,0,0,1,)(0,0,0,0,1,)(0,0,0,0,1,)(0,0,0,0,1,)(0,0,0,0,1,)(0,0,0,0,1,)(0,0,0,0,1,)(1,0,1,1,0,)(1,1,1,1,0,)(1,1,1,1,0,)(1,1,0,1,0,)(1,1,0,1,0,)(1,1,0,1,0,)(1,1,0,1,0,)(0,1,0,1,0,)
(0,0,0,0,1,)(0,0,0,0,1,)(0,0,0,0,1,)(0,0,0,0,1,)(0,0,0,0,1,)(0,0,0,0,1,)(0,0,0,0,1,)(0,0,0,0,1,)(0,0,0,0,1,)(0,0,0,0,1,)(0,0,0,0,1,)(0,0,0,0,1,)(1,0,1,0,0,)(1,1,1,0,0,)(1,1,1,0,0,)(1,1,1,1,0,)(1,1,1,0,0,)(1,1,1,1,0,)(0,1,1,1,0,)(0,0,1,1,0,)
(0,0,0,0,1,)(0,0,0,0,1,)(0,0,0,0,1,)(0,0,0,0,1,)(0,0,0,0,1,)(0,0,0,0,1,)(0,0,0,0,1,)(0,0,0,0,1,)(0,0,0,0,1,)(0,0,0,0,1,)(0,0,0,0,1,)(0,0,0,0,1,)(0,0,0,0,1,)(0,0,0,0,1,)(0,0,0,0,1,)(1,0,1,0,1,)(1,1,0,0,1,)(1,1,1,1,0,)(1,1,1,1,0,)(0,1,1,1,0,)
(0,0,0,0,1,)(0,0,0,0,1,)(0,0,0,0,1,)(0,0,0,0,1,)(0,0,0,0,1,)(0,0,0,0,1,)(0,0,0,0,1,)(0,0,0,0,1,)(0,0,0,0,1,)(0,0,0,0,1,)(0,0,0,0,1,)(0,0,0,0,1,)(0,0,0,0,1,)(0,0,0,0,1,)(0,0,0,0,1,)(0,0,0,0,1,)(0,0,0,0,1,)(1,0,1,1,0,)(1,1,1,1,0,)(0,1,1,1,0,)
(0,0,0,0,1,)(0,0,0,0,1,)(0,0,0,0,1,)(0,0,0,0,1,)(0,0,0,0,1,)(0,0,0,0,1,)(0,0,0,0,1,)(0,0,0,0,1,)(0,0,0,0,1,)(0,0,0,0,1,)(0,0,0,0,1,)(0,0,0,0,1,)(0,0,0,0,1,)(0,0,0,0,1,)(0,0,0,0,1,)(0,0,0,0,1,)(0,0,0,0,1,)(1,0,1,0,0,)(1,1,1,0,0,)(0,1,1,0,0,)
